si47x_tune_status	KEYWORD1
SI4735	KEYWORD1
RdsInit	KEYWORD2
analogPowerUp	KEYWORD2
digitalOutputFormat	KEYWORD2
digitalOutputSampleRate	KEYWORD2
downloadPatch	KEYWORD2
downloadPatchFromEeprom	KEYWORD2
frequencyDown	KEYWORD2
frequencyUp	KEYWORD2
getACFIndicator	KEYWORD2
getAgcGainIndex	KEYWORD2
getAntennaTuningCapacitor	KEYWORD2
getAutomaticGainControl	KEYWORD2
getBandLimit	KEYWORD2
getCommandResponse	KEYWORD2
getCurrentAfcRailIndicator	KEYWORD2
getCurrentAvcAmMaxGain	KEYWORD2
getCurrentBlendDetectInterrupt	KEYWORD2
getCurrentFrequency	KEYWORD2
getCurrentMultipath	KEYWORD2
getCurrentMultipathDetectHigh	KEYWORD2
getCurrentMultipathDetectLow	KEYWORD2
getCurrentPilot	KEYWORD2
getCurrentRSSI	KEYWORD2
getCurrentReceivedSignalQuality	KEYWORD2
getCurrentRssiDetectHigh	KEYWORD2
getCurrentRssiDetectLow	KEYWORD2
getCurrentSNR	KEYWORD2
getCurrentSignedFrequencyOffset	KEYWORD2
getCurrentSnrDetectHigh	KEYWORD2
getCurrentSnrDetectLow	KEYWORD2
getCurrentSoftMuteIndicator	KEYWORD2
getCurrentStereoBlend	KEYWORD2
getCurrentValidChannel	KEYWORD2
getCurrentVolume	KEYWORD2
getDeviceI2CAddress	KEYWORD2
getFirmware	KEYWORD2
getFirmwareCHIPREV	KEYWORD2
getFirmwareCMPMAJOR	KEYWORD2
getFirmwareCMPMINOR	KEYWORD2
getFirmwareFWMAJOR	KEYWORD2
getFirmwareFWMINOR	KEYWORD2
getFirmwarePATCHH	KEYWORD2
getFirmwarePATCHL	KEYWORD2
getFirmwarePN	KEYWORD2
getFrequency	KEYWORD2
getGroupLost	KEYWORD2
getNext2Block	KEYWORD2
getNext4Block	KEYWORD2
getNumRdsFifoUsed	KEYWORD2
getProperty	KEYWORD2
getRadioDataSystemInterrupt	KEYWORD2
getRdsFlagAB	KEYWORD2
getRdsGroupType	KEYWORD2
getRdsNewBlockA	KEYWORD2
getRdsNewBlockB	KEYWORD2
getRdsPI	KEYWORD2
getRdsProgramType	KEYWORD2
getRdsReceived	KEYWORD2
getRdsStatus	KEYWORD2
getRdsSync	KEYWORD2
getRdsSyncFound	KEYWORD2
getRdsSyncLost	KEYWORD2
getRdsText	KEYWORD2
getRdsText0A	KEYWORD2
getRdsText2A	KEYWORD2
getRdsText2B	KEYWORD2
getRdsTextSegmentAddress	KEYWORD2
getRdsTime	KEYWORD2
getRdsVersionCode	KEYWORD2
getReceivedSignalStrengthIndicator	KEYWORD2
getSignalQualityInterrupt	KEYWORD2
getStatus	KEYWORD2
getStatusCTS	KEYWORD2
getStatusError	KEYWORD2
getStatusMULT	KEYWORD2
getStatusResponse	KEYWORD2
getStatusSNR	KEYWORD2
getStatusValid	KEYWORD2
getTuneCompleteTriggered	KEYWORD2
getTuneFrequencyFast	KEYWORD2
getTuneFrequencyFreeze	KEYWORD2
getVolume	KEYWORD2
isAgcEnabled	KEYWORD2
isCurrentTuneAM	KEYWORD2
isCurrentTuneFM	KEYWORD2
isCurrentTuneSSB	KEYWORD2
mcuSleepDown	KEYWORD2
mcuWakeUp	KEYWORD2
patchPowerUp	KEYWORD2
powerDown	KEYWORD2
queryLibraryId	KEYWORD2
radioPowerUp	KEYWORD2
reset	KEYWORD2
seekStation	KEYWORD2
seekStationDown	KEYWORD2
seekStationProgress	KEYWORD2
seekStationUp	KEYWORD2
sendCommand	KEYWORD2
setAM	KEYWORD2
setAmSoftMuteMaxAttenuation	KEYWORD2
setAudioMode	KEYWORD2
setAudioMute	KEYWORD2
setAudioMuteMcuPin	KEYWORD2
setAutomaticGainControl	KEYWORD2
setAvcAmMaxGain	KEYWORD2
setBandwidth	KEYWORD2
setDeviceI2CAddress	KEYWORD2
setDeviceOtherI2CAddress	KEYWORD2
setFM	KEYWORD2
setFmBLendRssiMonoThreshold	KEYWORD2
setFmBLendSnrMonoThreshold	KEYWORD2
setFmBlendMonoThreshold	KEYWORD2
setFmBlendMultiPathMonoThreshold	KEYWORD2
setFmBlendMultiPathStereoThreshold	KEYWORD2
setFmBlendRssiStereoThreshold	KEYWORD2
setFmBlendSnrStereoThreshold	KEYWORD2
setFmBlendStereoThreshold	KEYWORD2
setFmStereoOff	KEYWORD2
setFmStereoOn	KEYWORD2
setFrequency	KEYWORD2
setFrequencyStep	KEYWORD2
setHardwareAudioMute	KEYWORD2
setI2CFastMode	KEYWORD2
setI2CFastModeCustom	KEYWORD2
setI2CLowSpeedMode	KEYWORD2
setI2CStandardMode	KEYWORD2
setMaxDelayPowerUp	KEYWORD2
setMaxDelaySetFrequency	KEYWORD2
setMaxSeekTime	KEYWORD2
setMcuClockSpeed	KEYWORD2
setMcuControl	KEYWORD2
setMcuWakeUpPin	KEYWORD2
setPowerUp	KEYWORD2
setProperty	KEYWORD2
setRdsConfig	KEYWORD2
setRdsIntSource	KEYWORD2
setSBBSidebandCutoffFilter	KEYWORD2
setSSB	KEYWORD2
setSSBAudioBandwidth	KEYWORD2
setSSBAutomaticVolumeControl	KEYWORD2
setSSBAvcDivider	KEYWORD2
setSSBBfo	KEYWORD2
setSSBConfig	KEYWORD2
setSSBDspAfc	KEYWORD2
setSSBSoftMute	KEYWORD2
setSeekAmLimits	KEYWORD2
setSeekAmRssiThreshold	KEYWORD2
setSeekAmSpacing	KEYWORD2
setSeekAmSrnThreshold	KEYWORD2
setSeekFmLimits	KEYWORD2
setSeekFmRssiThreshold	KEYWORD2
setSeekFmSpacing	KEYWORD2
setSeekFmSrnThreshold	KEYWORD2
setSsbSoftMuteMaxAttenuation	KEYWORD2
setTuneFrequencyAntennaCapacitor	KEYWORD2
setTuneFrequencyFast	KEYWORD2
setTuneFrequencyFreeze	KEYWORD2
setVolume	KEYWORD2
setup	KEYWORD2
ssbPowerUp	KEYWORD2
ssbSetup	KEYWORD2
volumeDown	KEYWORD2
volumeUp	KEYWORD2
waitToSend	KEYWORD2
si47x_agc_status	KEYWORD1
si47x_seek	KEYWORD1
si47x_bandwidth_config	KEYWORD1
si47x_firmware_query_library	KEYWORD1
si47x_rds_config	KEYWORD1
si47x_ssb_mode	KEYWORD1
si47x_rds_command	KEYWORD1
si47x_set_frequency	KEYWORD1
si47x_seek_am_complement	KEYWORD1
si473x_powerup	KEYWORD1
si47x_agc_overrride	KEYWORD1
si47x_firmware_information	KEYWORD1
si47x_status	KEYWORD1
si4735_digital_output_format	KEYWORD1
si47x_frequency	KEYWORD1
si4735_digital_output_sample_rate	KEYWORD1
si47x_rds_status	KEYWORD1
si47x_rds_int_source	KEYWORD1
si47x_rds_blockb	KEYWORD1
si47x_antenna_capacitor	KEYWORD1
si47x_property	KEYWORD1
si47x_response_status	KEYWORD1
si4735_eeprom_patch_header	KEYWORD1
si47x_rqs_status	KEYWORD1
si473x_gpio_ien	KEYWORD1
si473x_gpio	KEYWORD1
si47x_rds_blocka	KEYWORD1
si47x_rds_date_time	KEYWORD1
